TheWhiteRoom
An Interactive Fiction by Ming Chow
Release 1 / Serial number 120224 / Inform 7 build 6G60 (I6/v6.32 lib 6/12N) SD

White Room
In the white room with black curtains near the station. Black-roof country, no gold pavements, tired starlings. Silver horses run down moonbeams in your dark eyes. East is The Garden of Eden

>go east
Garden of Eden
You are now in The Garden of Eden. North is hell.

You see a pamplet on the ground. The pamplet looks worn and smells musky.

>gonorth
That's not a verb I recognise.

>go north
Hell
Home of the damed, you are now in Hell. To the west is a fire door that leads to The Matrix

You can see Satan here.

Greetings!

>go north
You can't go that way.

>go east
You can't go that way.

>go west
You can't go that way.

>go south
Garden of Eden
You are now in The Garden of Eden. North is hell.

You see a pamplet on the ground. The pamplet looks worn and smells musky.

>go north
Hell
Home of the damed, you are now in Hell. To the west is a fire door that leads to The Matrix

You can see Satan here.

>open door
You can't see any such thing.

>open fire door
You can't see any such thing.

* * *

>go east
Garden of Eden
You are now in The Garden of Eden. North is hell.

You see a pamplet on the ground. The pamplet looks worn and smells musky.

>go west
White Room
In the white room with black curtains near the station. Black-roof country, no gold pavements, tired starlings. Silver horses run down moonbeams in your dark eyes. East is The Garden of Eden

>go east
Garden of Eden
You are now in The Garden of Eden. North is hell.

You see a pamplet on the ground. The pamplet looks worn and smells musky.

>go north
Hell
Home of the damed, you are now in Hell.

You can see a fire door and Satan here.

Greetings!

>open door
You open the fire door.

>go east
You can't go that way.

>go west
The Matrix
Welcome to The Matrix, you have seen the light!

You can see a fire door here.

    *** You have won ***

In that game you scored 0 out of a possible 0, in 7 turns.

Would you like to RESTART, RESTORE a saved game, QUIT or UNDO the last command?

* * *

>go west
White Room
In the white room with black curtains near the station. Black-roof country, no gold pavements, tired starlings. Silver horses run down moonbeams in your dark eyes. East is The Garden of Eden

>go north
You can't go that way.

>go east
Garden of Eden
You are now in The Garden of Eden. North is hell.

You see a pamplet on the ground. The pamplet looks worn and smells musky.

>go north
Hell
Home of the damed.

You can see Satan here.

Greetings!

>go south
Garden of Eden
You are now in The Garden of Eden. North is hell.

You see a pamplet on the ground. The pamplet looks worn and smells musky.

>go north
Hell
Home of the damed.

You can see Satan here.

* * *

>go east
Garden of Eden
You are now in The Garden of Eden. North is hell.

You see a pamplet on the ground. The pamplet looks worn and smells musky.

>pick up pamplet
Taken.

>read pamplet
In a gadda da vida, baby (In the Garden of Eden) In a gadda da vida, honey Don't you know that I'm lovin" you

Oh, won't you come with me And take my hand Oh, won't you come with me And walk this land Please take my hand

In a gadda da vida, honey Don't you know that I'm lovin" you In a gadda da vida, baby Don't you know that I'll always be true

* * *

>go north
Hell
Home of the damed, you are now in Hell.

You can see a fire door and Satan here.

Greetings!

>talk to satan
That's not a verb I recognise.

>open door
You open the fire door.

>go north
You can't go that way.

* * *

>go east
You can't go that way.

>go south
Garden of Eden
You are now in The Garden of Eden. North is hell.

You see a pamplet on the ground. The pamplet looks worn and smells musky.

* * *

>go north
Hell
Home of the damed, you are now in Hell.

You can see a fire door and Satan here.

Greetings!

>go west
(first opening the fire door)
The Matrix
Welcome to The Matrix, you have seen the light!

You can see a fire door here.

    *** You have won ***

In that game you scored 0 out of a possible 0, in 3 turns.

Would you like to RESTART, RESTORE a saved game, QUIT or UNDO the last command?

* * *

TheWhiteRoom
An Interactive Fiction by Ming Chow
Release 1 / Serial number 120224 / Inform 7 build 6G60 (I6/v6.32 lib 6/12N) SD

White Room
In the white room with black curtains near the station. Black-roof country, no gold pavements, tired starlings. Silver horses run down moonbeams in your dark eyes. East is The Garden of Eden

>o north
Sorry, that can't be corrected.

>go west
You can't go that way.

>go west
You can't go that way.

>go east
Garden of Eden
You are now in The Garden of Eden. North is hell.

You see a pamplet on the ground. The pamplet looks worn and smells musky.

>go north
Hell
Home of the damed, you are now in Hell. To the west is The Matrix.

You can see Satan here.

Greetings!

>bo west
That's not a verb I recognise.

>go west
Matrix
Welcome to the Matrix!

* * *

TheWhiteRoom
An Interactive Fiction by Ming Chow
Release 1 / Serial number 120224 / Inform 7 build 6G60 (I6/v6.32 lib 6/12N) SD

White Room
In the white room with black curtains near the station. Black-roof country, no gold pavements, tired starlings. Silver horses run down moonbeams in your dark eyes. East is The Garden of Eden

>go north
You can't go that way.

* * *

>go east
Garden of Eden
You are now in The Garden of Eden. North is hell.

You see a pamplet on the ground. The pamplet looks worn and smells musky.

>go north
Hell
Home of the damed, you are now in Hell. To the west is a fire door that leads to The Matrix

You can see Satan here.

Greetings!

* * *

TheWhiteRoom
An Interactive Fiction by Ming Chow
Release 1 / Serial number 120224 / Inform 7 build 6G60 (I6/v6.32 lib 6/12N) SD

White Room
In the white room with black curtains near the station. Black-roof country, no gold pavements, tired starlings. Silver horses run down moonbeams in your dark eyes. East is The Garden of Eden

>go west
You can't go that way.

* * *

>go north
Hell
Home of the damed.

You can see Satan here.

Greetings!

>talk to the devil
That's not a verb I recognise.

>devil
That's not a verb I recognise.

>Satan
That's not a verb I recognise.

>talk to the Devil
That's not a verb I recognise.

>take Devil
I don't suppose Satan would care for that.

* * *

>go west
You can't go that way.

>go north
You can't go that way.

>go east
Garden of Eden
You are now in The Garden of Eden.

You can see a pamplet here.

>take it
Taken.

>take pamphlet
You can't see any such thing.

>burn it
This dangerous act would achieve little.

>eat it
That's plainly inedible.

>feel it
You feel nothing unexpected.

>look under it
You find nothing of interest.

>build a tent
That's not a verb I recognise.

>read it
In a gadda-da-vida, baby You know that I'm loving you In a gadda-da-vida, honey You know I'll always be true

Oh, won't you come with me And take my hand Oh, won't you come with me And walk this land Please take my hand

In a gadda da vida, honey Don't you know that I'm lovin" you In a gadda da vida, baby Don't you know that I'll always be true

>go west
White Room
In the white room with black curtains near the station. Black-roof country, no gold pavements, tired starlings. Silver horses run down moonbeams in your dark eyes. East is The Garden of Eden

* * *

TheWhiteRoom
An Interactive Fiction by Ming Chow
Release 1 / Serial number 120224 / Inform 7 build 6G60 (I6/v6.32 lib 6/12N) SD

White Room
In the white room with black curtains near the station. Black-roof country, no gold pavements, tired starlings. Silver horses run down moonbeams in your dark eyes. East is The Garden of Eden

>go south
You can't go that way.

>go east
Garden of Eden
You are now in The Garden of Eden.

You see a pamplet on the ground. The pamplet looks worn and smells musky.

>go south
You can't go that way.

>go west
White Room
In the white room with black curtains near the station. Black-roof country, no gold pavements, tired starlings. Silver horses run down moonbeams in your dark eyes. East is The Garden of Eden

>go west
You can't go that way.

>go east
Garden of Eden
You are now in The Garden of Eden.

You see a pamplet on the ground. The pamplet looks worn and smells musky.