#                            #
#                            #
#                            #
#                            #
#                            #
#                            #
#                            #
#                            #
#   *   *  *  *  *  *   *    #
#  o                      D  #
#                 w          #
#                            #
##############################
#                            #
#                            #
#                            #
#                            #
#              ####          #
###                          #
#                            #
#       ####            #### #
#                            #
#                            #
#            ######          #
########                     #
#                            #
#                            #
##############################
##############################
##############################
