XXXXXXXXXXXXXXXXXXXXXXXXXX
X            D           X
X                        X
X                        X
X                        X
X XXXXX             XXXX X
X XXXXX             XXXX X
X XXXXX             XXXX X
X                        X
X            K           X
X        XXXXXXXXX       X
X        XXXXXXXXX       X
X                        X
X                        X
X                        X
X                        X
X                        X
X                        X
X                        X
X                        X
X                        X
X                        X
X                        X
X                        X
X             B          X
XXXXXXXXXXXXXXXXXXXXXXXXXX
