XXXXXXXXXXXXXXXXXXXXXXXXXXX
X            D            X
X                         X
X                         X
X                         X
X XXXXX             XXXXX X
X XXXXX             XXXXX X
X XXXXX             XXXXX X
X                         X
X            K            X
X        XXXXXXXXX        X
X        XXXXXXXXX        X
X                         X
X                         X
X                         X
X                         X
X                         X
X                         X
X                         X
X                         X
X                         X
X                         X
X                         X
X                         X
X                         X
X             B           X
XXXXXXXXXXXXXXXXXXXXXXXXXXX
