XXXXXXXXXXXXXXXXXXXXXXXXXX
XUUUUUUUUUUUUUUUUUUUUUUUUX
X          D             X
X         XX        XX   X
X   XX                   X
XL            XX         X
XL  XX                   X
XL         XX      XX    X
XL                       X
X     E        XX       RX
X                       RX
X       XX              RX
X                       RX
X   CCC                  X
X                        X
X       XX       XX      X
X                        X
X          XX            X
X                        X
X            XX    XX    X
X                        X
X              XX        X
X                  K     X
X           XXX    X     X
X     B                 SX
XXXXXXXXXXXXXXXXXXXXXXXXXX
