XXXXXXXXXXXXXXXXXXXXXXXXXXX
XUUUUUUUUUUUUUUUUUUUUUUUUUX
XL                       RX
XL                       RX
XL                       RX
XL                       RX
XL                       RX
XL                       RX
XL XXX      XXX     XXX  RX
XL XXX      XXX     XXX  RX
XL                       RX
XL                       RX
XL XXX            K XXX  RX
XL XXX              XXX  RX
XL                       RX
XL           B           RX
XL XXX      XXX     XXX  RX
XL XXX      XXX     XXX  RX
XL                       RX
XL                       RX
XL                       RX
XL                       RX
XL      D                RX
XL                       RX
XL                       RX
XSSSSSSSSSSSSSSSSSSSSSSSSSX
XXXXXXXXXXXXXXXXXXXXXXXXXXX