XXXXXXXXXXXXXXXXXXXXXXXXXXX
XUUUUUUUUUUUUUUUUUUUUUUUUUX
XL                       RX
XL                       RX
XL                       RX
XL                       RX
XL XX        XX          RX
XL XX      K XX          RX
XL XX    XXXXXX          RX
XL XX                    RX
XL XX                    RX
XL          B            RX
XL         XXX           RX
XL         XXX           RX
XL                       RX
XL                       RX
XL         XX            RX
XL         XX D      XX  RX
XL         XXXXXX    XX  RX
XL                   XX  RX
XL                   XX  RX
XL                   XX  RX
XL                       RX
XL                       RX
XL                       RX
XSSSSSSSSSSSSSSSSSSSSSSSSSX
XXXXXXXXXXXXXXXXXXXXXXXXXXX