#                            #
#                            #
#     *               *      #
#                            #
#   *                   *    #
#     *               *      #
#                            #
#    ####            ####    #
#                            #
#*                         * #
#                            #
#             *              #
#   *                   *    #
#^                          ^#
####       *     *       #####
#                            #
#    *                 *     #
#         *       *          #
#                            #
#    *                 *     #
#         ^        ^         #
#         ##      ##         #
#o        ##      ##      D  #
#      #####      #####      #
#     ^#####      #####^     #
############      ############
############xxxxxx############
##############################
##############################
##############################
