TheWhiteRoom
An Interactive Fiction by Ming Chow
Release 1 / Serial number 120222 / Inform 7 build 6G60 (I6/v6.32 lib 6/12N) SD

White Room
In the white room with black curtains near the station. Black-roof country, no gold pavements, tired starlings. Silver horses run down moonbeams in your dark eyes. East is The Garden of Eden

>go east
You can't go that way.

>pick up pamplet
Taken.

>read pamplet
In a gadda da vida, baby (In the Garden of Eden) In a gadda da vida, honey Don't you know that I'm lovin" you

Oh, won't you come with me And take my hand Oh, won't you come with me And walk this land Please take my hand

In a gadda da vida, honey Don't you know that I'm lovin" you In a gadda da vida, baby Don't you know that I'll always be true

* * *

TheWhiteRoom
An Interactive Fiction by Ming Chow
Release 1 / Serial number 120222 / Inform 7 build 6G60 (I6/v6.32 lib 6/12N) SD

White Room
In the white room with black curtains near the station. Black-roof country, no gold pavements, tired starlings. Silver horses run down moonbeams in your dark eyes. East is The Garden of Eden

>go west
You can't go that way.

>go north
You can't go that way.

>go east
Garden of Eden
You are now in The Garden of Eden.

You can see a pamplet here.

>take it
Taken.

>take pamphlet
You can't see any such thing.

>burn it
This dangerous act would achieve little.

>eat it
That's plainly inedible.

>feel it
You feel nothing unexpected.

>look under it
You find nothing of interest.

>build a tent
That's not a verb I recognise.

>read it
In a gadda-da-vida, baby You know that I'm loving you In a gadda-da-vida, honey You know I'll always be true

Oh, won't you come with me And take my hand Oh, won't you come with me And walk this land Please take my hand

In a gadda da vida, honey Don't you know that I'm lovin" you In a gadda da vida, baby Don't you know that I'll always be true

>go west
White Room
In the white room with black curtains near the station. Black-roof country, no gold pavements, tired starlings. Silver horses run down moonbeams in your dark eyes. East is The Garden of Eden