You find yourself in a Back Alley, clothes dirty and fingernails crusted.  You look down at yourself and take in your appearance; the ragged jacket, fingerless gloves, shopping bag shoes, and tattered pants all add to your incredibly homeless appearance.  Your chipped nametag reads "Bobo".  You look up and see an opening at the end of the alley; there is a chain link fence behind you and buildings on either side.  Rising from your soggy cardboard bed, you stretch and get ready to start the day. 
Looking around you, however, your stomach plunges as you realize that something is wrong.  Your most prized possession in the world is missing: your polka-dotted bindle.  You angrily adorn your paper bag hat and start thinking about how to retrieve what is rightfully yours.

Bobo Dihobo
An Interactive Fiction by Tucker Stone understand "above" as up
Release 1 / Serial number 120311 / Inform 7 build 6G60 (I6/v6.32 lib 6/12N) SD

Back Alley
A dingy, foul-smelling alley.  Puddles of unknown liquids and piles of unknown solids surround you.  To the north you can see an opening in the buildings.  Your own personal box is just  south of you.

A small box lies by the wall, somewhat greasy and wet.

>poop self
That's not a verb I recognise.

* * *

>open boxes
That's not something you can open.

>take boxes
Taken.

>look
Back Alley
You find yourself in a Back Alley, clothes dirty and fingernails crusted.  You look down at yourself and see the body of a dirty hobo.  Your chipped nametag reads "Bobo".  You look up and see an opening at the end of the Alley, and a few boxes in a pile.

* * *

>take boxes
Taken.

>open boxes
That's not something you can open.

>boxes
That's not a verb I recognise.

>go north
Commons

* * *

>look
Back Alley
You find yourself in a Back Alley, clothes dirty and fingernails crusted.  You look down at yourself and see the body of a dirty hobo.  Your chipped nametag reads "Bobo".  You look up and see an opening at the end of the Alley, and a few boxes in a pile.

* * *

>go north
Commons
A large area with burning barrels and some benches.  You can see someone warming himself by the fire, and a dog rooting through some trash.  The Back Alley is south of you, there is a large building to the north with a locked door, and the street is to the east.

A large door blocks your way to the north.  There is a sign that says "5 dollar entry."

You recognize the scrawny man by the fire as Skinny Steve, a friendly hobo.  You should ask him about how he is.

The dog's collar reads Woofy.  He seems to be snuffling around eagerly in the trash.

>go south
Back Alley
You find yourself in a Back Alley, clothes dirty and fingernails crusted.  You look down at yourself and see the body of a dirty hobo.  Your chipped nametag reads "Bobo".  You look up and see an opening at the end of the Alley, and a few boxes in a pile.

You can see a box (in which is a sandwich) here.

* * *

>go north
Commons
A large area with burning barrels and some benches.  You can see someone warming himself by the fire, and a dog rooting through some trash.  The Back Alley is south of you, there is a large building to the north with a locked door, and the street is to the east.

A large door blocks your way to the north.  There is a sign that says "5 dollar entry."

You recognize the scrawny man by the fire as Skinny Steve, a friendly hobo.  You should ask him about how he is.

The dog's collar reads Woofy.  He seems to be snuffling around eagerly in the trash.

>ask skinny steve how he is
I didn't understand that sentence.

>ask skinny steve about how he is
Skinny Steve whips around, startled by your stealthy approach. "Oh, its just you.  Good to see you, Bobo."

* * *

>go north
Commons
A large area with burning barrels and some benches.  You can see someone warming himself by the fire, and a dog rooting through some trash.  The Back Alley is south of you, there is a large building to the north with a locked door, and the street is to the east.

A large door blocks your way to the north.  There is a sign that says "5 dollar entry."

You recognize the scrawny man by the fire as Skinny Steve, a friendly hobo.  You should ask him about how he is.

The dog's collar reads Woofy.  He seems to be snuffling around eagerly in the trash.

>ask skinny steve about how he is
Skinny Steve whips around, startled by your stealthy approach. "Oh, its just you.  Good to see you, Bobo."

>ask skinny steve about how he is
Skinny Steve grimaces and looks down at his stomach.  He looks hungry.

* * *

>go north
Commons
A large area with burning barrels and some benches.  You can see someone warming himself by the fire, and a dog rooting through some trash.  The Back Alley is south of you, there is a large building to the north with a locked door, and the street is to the east.

A large door blocks your way to the north.  There is a sign that says "5 dollar entry."

You recognize the scrawny man by the fire as Skinny Steve, a friendly hobo.  You should ask him about how he is.

The dog's collar reads Woofy.  He seems to be snuffling around eagerly in the trash.

>look skinny steve
A skinny, shivering man.  He seems to have no body fat, the poor man.

>more skinny steve
That's not a verb I recognise.

>speak skinny steve
Whom do you want to speak that to?

>skinny steve
There is no reply.

>speak to skinny steve
I didn't understand that sentence.

* * *

>go north
Commons
A large area with burning barrels and some benches.  You can see someone warming himself by the fire, and a dog rooting through some trash.  The Back Alley is south of you, there is a large building to the north with a locked door, and the street is to the east.

A large door blocks your way to the north.  There is a sign that says "5 dollar entry."

You recognize the scrawny man by the fire as Skinny Steve, a friendly hobo.  You should ask him about how he is.

The dog's collar reads Woofy.  He seems to be snuffling around eagerly in the trash.

>pet Woofy
That's not a verb I recognise.

>petting woofy
That's not a verb I recognise.

* * *

>go north
Commons
A large area with burning barrels and some benches.  You can see someone warming himself by the fire, and a dog rooting through some trash.  The Back Alley is south of you, there is a large building to the north with a locked door, and the street is to the east.

A large door blocks your way to the north.  There is a sign that says "5 dollar entry."

You recognize the scrawny man by the fire as Skinny Steve, a friendly hobo.  You should ask him about how he is.

The dog's collar reads Woofy.  He seems to be snuffling around eagerly in the trash.

>pet woofy
You pet Woofy.  He barks and wags his tail, then snuffles around in the trash and drags out a pair of ratty pants.  An old 2 dollar bill pokes from the pocket, and you grab it with glee.

[Your score has just gone up by two points.]

>pet
You must supply a noun.

>pet Woofy
I only understood you as far as wanting to pet.

* * *

>pet woofy
You pet Woofy.  He barks and wags his tail, then snuffles around in the trash and drags out a pair of ratty pants.  An old 2 dollar bill pokes from the pocket, and you grab it with glee.

[Your score has just gone up by two points.]

>pet woofy
You pet Woofy.  He barks and wags his tail, then snuffles around in the trash and drags out a pair of ratty pants.  An old 2 dollar bill pokes from the pocket, and you grab it with glee.

* * *

>go north
Commons
A large area with burning barrels and some benches.  You can see someone warming himself by the fire, and a dog rooting through some trash.  The Back Alley is south of you, there is a large building to the north with a locked door, and the street is to the east.

A large door blocks your way to the north.  There is a sign that says "5 dollar entry."

You recognize the scrawny man by the fire as Skinny Steve, a friendly hobo.  You should ask him about how he is.

The dog's collar reads Woofy.  He seems to be snuffling around eagerly in the trash.

>go north
You walk up to the solid door and knock.  A gruff voice says "Its 5 dollars to get in here,  you stinky bum.  Good luck coming up with any money."  You frown and turn back.

>open steel door
It seems to be locked.

* * *

>go north
You walk up to the solid door and knock.  A gruff voice says "Its 5 dollars to get in here,  you stinky bum.  Good luck coming up with any money."  You frown and turn back.

>go south
Back Alley
A dingy, foul-smelling alley.  Puddles of unknown liquids and piles of unknown solids surround you.  To the north you can see an opening in the buildings.

A small box lies by the wall, somewhat greasy and wet.

>go north
Commons
A large area with burning barrels and some benches.  You can see someone warming himself by the fire, and a dog rooting through some trash.  The Back Alley is south of you, there is a large building to the north with a locked door, and the street is to the east.

A large door blocks your way to the north.  There is a sign that says "5 dollar entry."

You recognize the scrawny man by the fire as Skinny Steve, a friendly hobo.  You should ask him about how he is.

The dog's collar reads Woofy.  He seems to be snuffling around eagerly in the trash.

* * *

>open steel door
You open the Steel Door.

* * *

>go north
You walk up to the solid door and knock.  A gruff voice says "Its 5 dollars to get in here,  you stinky bum.  Good luck coming up with any money."  You frown and turn back.

>bo south
That's not a verb I recognise.

>go south
Back Alley
A dingy, foul-smelling alley.  Puddles of unknown liquids and piles of unknown solids surround you.  To the north you can see an opening in the buildings.

A small box lies by the wall, somewhat greasy and wet.

>take box
You pick up the small box.

>take sandwich
You grasp the sandwich with your dirty hands and put it safely in a secret pocket, deep within your coat.

>go north
Commons
A large area with burning barrels and some benches.  You can see someone warming himself by the fire, and a dog rooting through some trash.  The Back Alley is south of you, there is a large building to the north with a locked door, and the street is to the east.

A large door blocks your way to the north.  There is a sign that says "5 dollar entry."

You recognize the scrawny man by the fire as Skinny Steve, a friendly hobo.  You should ask him about how he is.

The dog's collar reads Woofy.  He seems to be snuffling around eagerly in the trash.

* * *

>ask skinny steve about how he is
Skinny Steve whips around, startled by your stealthy approach. "Oh, its just you.  Good to see you, Bobo."

>give sandwich
Skinny Steve's mouth waters and stomach growls as you flourish the sandwich you found earlier. "Please, Bobo.  Gimme that!  You wont regret it." 
 You reluctantly hand over the sandwich.  Skinny Steve cackles and says "Much obliged.  Here's a buck, its all I have."

[Your score has just gone up by one point.]

>pet woofy
You pet Woofy.  He barks and wags his tail, then snuffles around in the trash and drags out a pair of ratty pants.  An old 2 dollar bill pokes from the pocket, and you grab it with suprise and glee.  Do these things even count as money anymore?

[Your score has just gone up by two points.]

>go east
Street
Cars drive by on occasion, and pedestrians walk by briskly.  This area is a commonly-frequented begging area in the hobo community.

Pedestrians hustle and bustle; you can almost smell the money in their pockets.

>beg pedestrians
You put forth your hands and mumble incoherently about spare change.  Most pedestrians turn down their head and walk faster, but a select few throw some coins at you.  You've gathered a measly dollar; perhaps you should try again.
Once again, you accost the pedestrians and ask for money.  One college student takes pity and gives you a dollar bill.  You whistle a thank you through your remaining teeth and pocket the bill.

[Your score has just gone up by two points.]

>go west
Commons
A large area with burning barrels and some benches.  You can see someone warming himself by the fire, and a dog rooting through some trash.  The Back Alley is south of you, there is a large building to the north with a locked door, and the street is to the east.

A large door blocks your way to the north.  There is a sign that says "5 dollar entry."

You recognize the scrawny man by the fire as Skinny Steve, a friendly hobo.  You should ask him about how he is.

The dog's collar reads Woofy.  He seems to be snuffling around eagerly in the trash.

You walk up to the Steel Door and knock angrily on the door. "Listen pal, if you don't shove off ill-"  The voice cuts off as you produce the money you've scrounged together.  After a few heavy clunks, the door creaks open.

>go north
Lobby
A large door blocks your way to the north.  There is a sign that says "5 dollar entry."

* * *

>go north
Commons
A large area with burning barrels and some benches.  You can see someone warming himself by the fire, and a dog rooting through some trash.  The Back Alley is south of you, there is a large building to the north with a locked door, and the street is to the east.

A large door blocks your way to the north.  There is a sign that says "5 dollar entry."

You recognize the scrawny man by the fire as Skinny Steve, a friendly hobo.  You should ask him about how he is.

The dog's collar reads Woofy.  He seems to be snuffling around eagerly in the trash.

>open steel door
It seems to be locked.

>go south
Back Alley
A dingy, foul-smelling alley.  Puddles of unknown liquids and piles of unknown solids surround you.  To the north you can see an opening in the buildings.

A small box lies by the wall, somewhat greasy and wet.

>take sandwich
You can't see any sandwich.

>take box
You pick up the small box.

* * *

>take sandwich
You grasp the sandwich with your dirty hands and put it safely in a secret pocket, deep within your coat.

>go north
Commons
A large area with burning barrels and some benches.  You can see someone warming himself by the fire, and a dog rooting through some trash.  The Back Alley is south of you, there is a large building to the north with a locked door, and the street is to the east.

You recognize the scrawny man by the fire as Skinny Steve, a friendly hobo.  You should ask him about how he is.

The dog's collar reads Woofy.  He seems to be snuffling around eagerly in the trash.

>ask skinny steve about how he is
Skinny Steve whips around, startled by your stealthy approach. "Oh, its just you.  Good to see you, Bobo."

>ask skinny steve about how he is
Skinny Steve grimaces and looks down at his stomach.  He looks hungry.  You feel a twinge of pity and think about giving him some food

>give sandwich
Skinny Steve's mouth waters and stomach growls as you flourish the sandwich you found earlier. "Please, Bobo.  Gimme that!  You wont regret it." 
 You reluctantly hand over the sandwich.  Skinny Steve cackles and says "Much obliged.  Here's a buck, its all I have."

[Your score has just gone up by one point.]

* * *

>go east
Street
Cars drive by on occasion, and pedestrians walk by briskly.  This area is a commonly-frequented begging area in the hobo community.

Pedestrians hustle and bustle; you can almost smell the money in their pockets.

>beg
You must supply a noun.

>beg pedestrians
You put forth your hands and mumble incoherently about spare change.  Most pedestrians turn down their head and walk faster, but a select few throw some coins at you.  You've gathered a measly dollar; perhaps you should try again.
Once again, you accost the pedestrians and ask for money.  One college student takes pity and gives you a dollar bill.  You whistle a thank you through your remaining teeth and pocket the bill.

[Your score has just gone up by two points.]

>go west
Commons
A large area with burning barrels and some benches.  You can see someone warming himself by the fire, and a dog rooting through some trash.  The Back Alley is south of you, there is a large building to the north with a locked door, and the street is to the east.

You recognize the scrawny man by the fire as Skinny Steve, a friendly hobo.  You should ask him about how he is.

The dog's collar reads Woofy.  He seems to be snuffling around eagerly in the trash.

You knock angrily on the door. "Listen pal, if you don't shove off ill-"  The voice cuts off as you produce the money you've scrounged together.  After a few heavy clunks, the door creaks open and you enter the musty building

>go north
(first opening the Steel Door)
It seems to be locked.

You knock angrily on the door. "Listen pal, if you don't shove off ill-"  The voice cuts off as you produce the money you've scrounged together.  After a few heavy clunks, the door creaks open and you enter the musty building

* * *

>take box
You pick up the small box.

>open box
You open the box and see a delicious looking sandwich.

>take sandwich
Taken.

>look box
You see nothing special about the box.

* * *

>take sandwich
Taken.

>look sandwich
You see nothing special about the sandwich.

>inventory
You are carrying:
  a sandwich
  a box

* * *

>take sandwich
Taken.

>eat sandwich
You eat the sandwich. Not bad.

* * *

>take sandwich
Taken.

>go north
Commons
A large area with burning barrels and some benches.  You can see someone warming himself by the fire, and somebody else  rooting through trash with a dog by his side.

You recognize the scrawny man by the fire as Skinny Steve, a friendly hobo.

You can also see Roofy the Dog here.

>ask Skinny Steven what's up
I didn't understand that sentence.

>ask Skinny Steve what's up
I didn't understand that sentence.

>ask Skinny Steve about what's up
Skinny Steve whips around, startled by your stealthy approach. "Oh, its just you.  Good to see you, Bobo.""

* * *

>open box
You open the box and see a delicious looking sandwich.

>open box
That's not something you can open.

* * *

>open box
You open the box and see a delicious looking sandwich.

>go north
Commons
A large area with burning barrels and some benches.  You can see one hobo warming himself by the fire, and another  rooting through trash with a dog by his side.

You can see Skinny Steve here.

>greet Skinny Steve
That's not a verb I recognise.

>talk skinny steve
That's not a verb I recognise.

>speak skinny steve
(to Skinny Steve)
There is no reply.

* * *

>take box
You pick up the small box.

>look box
A tattered and damp box.  An intriguing smell wafts through the flaps.

In the box is a sandwich.

>take sandwich
Taken.

* * *

>go north
Commons
A large area with burning barrels and some benches.  You can see someone warming himself by the fire, and a dog rooting through some trash.  The Back Alley is south of you, there is a large building to the north with a locked door, and the street is to the east.

You recognize the scrawny man by the fire as Skinny Steve, a friendly hobo.  You should ask him about how he is.

The dog's collar reads Woofy.  He seems to be snuffling around eagerly in the trash.

>pet woofy
You pet Woofy.  He barks and wags his tail, then snuffles around in the trash and drags out a pair of ratty pants.  An old 2 dollar bill pokes from the pocket, and you grab it with suprise and glee.  Do these things even count as money anymore?

[Your score has just gone up by two points.]

>ask skinny steve about how he is
Skinny Steve whips around, startled by your stealthy approach. "Oh, its just you.  Good to see you, Bobo."

* * *

>give sandwich
Skinny Steve's mouth waters and stomach growls as you flourish the sandwich you found earlier. "Please, Bobo.  Gimme that!  You wont regret it." 
 You reluctantly hand over the sandwich.  Skinny Steve cackles and says "Much obliged.  Here's a buck, its all I have."

[Your score has just gone up by one point.]

>go east
Street
Cars drive by on occasion, and pedestrians walk by briskly.  This area is a commonly-frequented begging area in the hobo community.

Pedestrians hustle and bustle; you can almost smell the money in their pockets.

>beg pedestrians
You put forth your hands and mumble incoherently about spare change.  Most pedestrians turn down their head and walk faster, but a select few throw some coins at you.  You've gathered a sweet dollar and are feeling good about your begging; perhaps you should have another go at it.

[Your score has just gone up by one point.]

>go west
Commons
A large area with burning barrels and some benches.  You can see someone warming himself by the fire, and a dog rooting through some trash.  The Back Alley is south of you, there is a large building to the north with a locked door, and the street is to the east.

You recognize the scrawny man by the fire as Skinny Steve, a friendly hobo.  You should ask him about how he is.

The dog's collar reads Woofy.  He seems to be snuffling around eagerly in the trash.

You knock angrily on the door. "Listen pal, if you don't shove off ill-"  The voice cuts off as you produce the money you've scrounged together.  After a few heavy clunks, the door creaks open and you enter the musty building

>go north
(first opening the Steel Door)
It seems to be locked.

* * *

>beg pedestrians
You put forth your hands and mumble incoherently about spare change.  Most pedestrians turn down their head and walk faster, but a select few throw some coins at you.  You've gathered a sweet dollar and are feeling good about your begging; perhaps you should have another go at it.

[Your score has just gone up by one point.]

>beg pedestrians
Once again, you accost the pedestrians and ask for money.  One college student stops, however.   "Here you go, man.  Good luck!" He reaches into his pocket and gives you a dollar bill.  You whistle a thank you through your remaining teeth and pocket the bill.

[Your score has just gone up by one point.]

>go west
Commons
A large area with burning barrels and some benches.  You can see someone warming himself by the fire, and a dog rooting through some trash.  The Back Alley is south of you, there is a large building to the north with a locked door, and the street is to the east.

You recognize the scrawny man by the fire as Skinny Steve, a friendly hobo.  You should ask him about how he is.

The dog's collar reads Woofy.  He seems to be snuffling around eagerly in the trash.

You walk up to the Steel Door and knock angrily on the door. "Listen pal, if you don't shove off ill-"  The voice cuts off as you produce the money you've scrounged together.  After a few heavy clunks, the door creaks open.

>go north
The Lobby
The door slams shut behind you.  The air is dusty and dry, and  old tapestries and rugs decorate the area.  There are stairs at the end of the room, but the room is mysteriously empty apart from that.

>go up
Upstairs
A long hallway with multiple rooms branching off.   There are doors to the east,  west,  north, and an attic door  above  you.

A white pamphlet lies on the ground, its pure white color an unsettling contrast to the dusty and dank appearance of the house.

You can also see a wooden door here.

>take pamphlet
Taken.

>read pamphlet
You open up the pamphlet and read  the contents: "Hello there.  I see that you have at last done something productive and made your way to this building.  You see, every day I look outside and see filth like you wandering around, mooching from society and being unpleasant to the sight and smell.  I have been luring dirty humans like you into this house for weeks by taking their boxes, and sleeping bags, and polka dotted bindles. 
  You, sir, have a challenge ahead of you.  IF you find what is yours, then you have passed the test and may leave.  Otherwise, you will find my accomplices downstairs...less than forgiving.
  You have 12 hours.  Use them wisely.

* * *

>take pamphlet
Taken.

>go east
Bedroom
You appear to be in an old bedroom.  The layer of dust on everything is thick and oppressive, and the bed looks uncomfortable and old.  Light drifts in from the window, illuminating the thick air.

You can see a cabinet (closed) here.

>open cabinet
It seems to be locked.

>look cabinet
You see nothing special about the cabinet.

>more cabinet
That's not a verb I recognise.

>go west
Upstairs
A long hallway with multiple rooms branching off.   There are doors to the east,  west,  north, and an attic door  above  you.

You can see a wooden door here.

>go north
(first opening the wooden door)

closet
A tiny closet devoid of any clothes, boots, or items.  Perhaps you should check more carefully.

There doesnt appear to be anything here...?

You can also see a wooden door here.

Upon further inspection, you notice a note stuck above the door frame, out of sight.

>look around
You can't see any such thing.

>look
closet
A tiny closet devoid of any clothes, boots, or items.  Perhaps you should check more carefully.

There doesnt appear to be anything here...?

You can also see a wooden door here.

Upon further inspection, you notice a note stuck above the door frame, out of sight.