XXXXXXXXXXXXXXXXXXXXXXXXXX
XKXD                     X  
X XXXXXXXXXXXXXXXXXXXXX  X
X X   U   U   U   U      X
X                       RX
X XSSSSSSSSSSSSSSSSSSXXSSX
X XXXXXXXXXXXXXXXXXXXXXXXX
X X                      X
X X                      X
X X                      X
X X                      X
X X    X    X   XXXXXXX  X
X X    X    X      X     X
X X    X    X      X     X
X X    X    X      X     X
X X    X    X      X     X
X X    XXXXXX      X     X
X X    X    X      X     X
X X    X    X      X     X
X X    X    X      X     X
X X    X    X   XXXXXXX  X
X X                      X
X X                      X
X X                      X
XBX                      X
XXXXXXXXXXXXXXXXXXXXXXXXXX