XXXXXXXXXXXXXXXXXXXXXXXXXXX
XUUUUUUUUUUUUUUUUUUUUUUUUUX
XL                       RX
XL     XX                RX
XL     XX  D             RX
XL     XX                RX
XL     XX                RX
XL     XX                RX
XL     XX                RX
XL     XX                RX
XL     XX                RX
XL                       RX
XL                       RX
XL                       RX
XL                       RX
XL                       RX
XL                       RX
XL                 XXX   RX
XL                 XXX   RX
XL           XXX   XXX   RX
XL           XXX   XXX   RX
XL      XXX  XXX   XXX   RX
XL  B   XXX  XXX K XXX   RX
XL XXX  XXX  XXX   XXX   RX
XL XXX  XXX  XXX   XXX   RX
XSSXXXSSXXXSSXXXSSSXXXSSSSX
XXXXXXXXXXXXXXXXXXXXXXXXXXX
